111111
1C0011
110001
111011
1P00E1
111111