11111111111111
10010000000C111111
1000011111001
1P0011E000001
11111111111111111