1111111111111
1001110011111
100AA0AA0A0C1
10000A00A1001
1P0011E000001
1111111111111