1111111111111111111111111111111111
1EA000000000000C00000C000000000001
1011110100100000101001AAAAAAA10101
1010010010101010001001000000010101
1P0000000C00C0000000010CCCCCC00AC1
1C0000000C00C0000000010CCCCCC00AC1
1111111111111111111111111111111111